11111111
100P01111
1E00C001111
11111111
