111111111111
1000ECCP1111
100011911111
111111111111
