111111111111111111111111
11CCEXCXCEE0001100XXCC11
11C100XCP00CC000EX0X1111
11000CC000C0CX0000000011
111111111111111111111111
