111111111111111111111111
1100001EECCC11001P1CC111
110000CC000C0C0CEC000011
10000CC00C0EC000CC001111
111111111111111111111111
