111111111111111111111111
11X000C00000C000P00E1111
10000E000CCC0000CC000011
1ECC00000X0000CCC0000011
111111111111111111111111
