1111111111111111111111111111111111
1E0000000000000CX000010000X0000001
1010010100100000101001010010010101
1010010010101010001001010010010101
1010010010101010X010010100X0010101
10100100101X1010001001010000010101
1010010010101010X010010100X0010101
1010010010101010001001010000010101
1010011111101010X010010100X0010101
1P0000000C0XC0000010000100000000C1
1111111111111111111111111111111111
